%%%%%%%%%%%%%%%%%%%%%%%%%%%%%%%%%%%%%
%X      %                         % %
%         %%%%% % %%% %%% %%%%%%% % %
%       %       % %     %     % %   %
%%%%% %%%%% %%% % % % %%% %%%%% % %%%
%   % % % %   % % % %   % %     %   %
% %%% % % % %%% %%%%% %%% % %%% %%% %
%       %     %   %   %     % % %   %
%%% %%%%%%%%% %%%%%%% %%% %%% % % % %
%             %       % %   %     % %
% % %%%%% % %%% % % %%% % %%% %%% % %
% % %     % % % % %     %   % % % % %
% % % %%%%%%% % %%%%%%%%% %%% % %%% %
% % % %     %   %     %     %   %   %
%%% %%% % %%%%% %%%%% %%% %%% %%%%% %
%     % %               % %   % % % %
% % % % %  %  %%% %%% %%% % % % % % %
% % % % % %%  % % % % %   % % %     %
% % %%%%%  %  %%% %%% % %%% %%% %%%%%
%       %  %  % % % % %       % %   %
% %%% % %  %  %%% %%% %%%%%%%%% % %%%
%   % %                   %   % %   %
% %%% %%%%%%%%%%%%%%%%%%%%% % % %%% %
% %                         %       %
% % % %%%%% %%% % % % % %%%%%%%%%%%%%
% % %   %     % % % %       %   % % %
% % %%% %%% % % % %%%%%%%%% %%% % % %
% %   % %   % % %P  % %   % % %     %
% %%% %%% %%% % %%% % % %%%%% % %%%%%
%       %   %     %       %   % %   %
%%% % %%%%% %%%%% %%% %%% % %%% % %%%
% % % % % % % %     % %   % %   % % %
% % %%% % % % % %%%%%%%%% % % % % % %
%       %                     %     %
% %   % %%% %%% %%%%%%% %%% %%% %%% %
% %   %       %           %     %   %
%%%%%%%%%%%%%%%%%%%%%%%%%%%%%%%%%%%%%
