%%%%%%%%%%%%%%%%%%%%%%%%%%%%%%%
%     %                 %    X%
% %%% % %%% %%%%%%% %%% %     %
% %   % %      %      % %     %
%   %%% % %%%% % %%%%   %%%   %
%%% % % % %      %  % %   % %%%
%   % %%% % %%% %%% % %%% %   %
% %%%       %     %       %%% %
%   % %%%%% %%%%%%% % %%% %   %
%%% %   % %    %    % %   % %%%
%   %%% % %%%% % %%%% % %%%   %
%       %      %      %     % %
%     % %%% %%%%%%% %%% % %%% %
%     %        P    %   %     %
%%%%%%%%%%%%%%%%%%%%%%%%%%%%%%%
