%%%%%%%%%%%%%%
%          % %
%        X % %
%          %G%
%          % %
%          % %
%          % %
%          % %
%     P    %G%
%          % %
%          % %
%          % %
%          % %
%%%%%%%%%%%%%%
