%%%%%%%%%%%%%%%%%%%
%G        G      X%
% % % %%%%%% % %% %
% % % %    % %  % %
% %%% %  %%% %  % %
%       P    %  %G%
%%%%%%%%%%%%%%%%%%%%
