%%%%%%%%%%%%%%%%%%%%%
%                   %
%                   %
%                   %
%                   %
%         P         %
%                   %
%                   %
%                   %
%                  X%
%%%%%%%%%%%%%%%%%%%%%
