%%%%%%%%%%%%%%%%%%%%
%    %        %    %
% %% % %%  %% % %% %
%       G GG%      %
% % %% %% %%% %% % %
% %    %    % %  % %
% % %% % %% % % %% %
% %      P    %X   %
%%%%%%%%%%%%%%%%%%%%
