%%%%%%
%X   %
% %% %
% %% %
% P  %
% %%%%
%    %
%%%%%%
