%%%%%%%%%%%%%%%%%%%%%%%%%%%%%%%
%            %%%%%            %
%%% %   %%%         % %   % %%%
%   %%% % %%%% % %%%%%% %%%   %
% %     %      %      %     % %
% %%% %%%%% %%%%%%% %%% % %%%%%
%     %        P    %X  %     %
%%%%%%%%%%%%%%%%%%%%%%%%%%%%%%%
