%%%%%%%%%%%%%%%%%%%%%%%%%%%%%%%
% %         %% G %%%%%%    %%X%
% % %%%%%%% %%%%%%%     %%%%% %
% %%% %%%%% %%%%%%% %%% % %%% %
%              P    %         %
%%%%%%%%%%%%%%%%%%%%%%%%%%%%%%%
