%%%%%%%%%
% P    G% 
% % %G%%%  
%G   X%%%
%%%%%%%%%
