%%%%%%%%%%%%%%%%%%%%
%X  %         %%   %
% % % %%%%%%%%%% % %
%                  %
%%%%%%%% % %%%%%%%P%
%%%%%%%%           %
%%%%%%%%%%%%%%%%%%%%
