%%%%%%%%%%%%%%%%%%%%
%                  %
%                  %
%        P         %
%                  %
%                X %
%%%%%%%%%%%%%%%%%%%%
