%%%%%%%%%%%%%%%%%%%%
%      %GGGG%      %
%  %   %%  %%   %  %
% %  %        %  % %
%  % % %%%%%% % %  %
%        P         %
%%%%%%%%%%%%%%%%%%%%
