%%%%%%%%%%%%%%%%%%%%
%      %G  G%     X%
% %%   %%  %%   %% %
% %  %        %  % %
% %% % %%%%%% % %% %
%        P         %
%%%%%%%%%%%%%%%%%%%%
