%%%%%%%%%
%X  % G %
%%% %%%%%
%       %
%%%%%%% %
%       %
% %%%%% %
%     % %
%%%%% % %
%     % %
% %%%%%%%
%       %
%%%%%%% %
%P      %
%%%%%%%%%
