%%%%%%%%%%%%%%%%%%%%
%               P  %
% %% %% %% %% %% % %
% %% %X          % %
%%%%%%%%%%%%%%%%%%%%
