%%%%%%%%%%
%X      P%
%%%%%%%%%%
