%%%%%
% P %
%%% %
%X  %
%%%%%
