%%%%%
%X  %
% G %
%   %
%   %
%   %
%   %
%   %
%P  %
%%%%%
