%%%%%%%%
%      %
%   P  %
% %%%% %
% %    %
% % %%%%
% %   X%
%%%%%%%%
