%%%%%%%%%
%       %
%%%% %% %
%   P   %
% %% %% %
% %X    %
%%%%%%%%%
