%%%%%%%%%
% G %   %
%%%%%%% %
%P      %
% %% %% %
% %%X   %
%%%%%%%%%
