%%%%%%%
%    P%
% %%% %
%  %  %
%%   %%
%X %%%%
%%%%%%%
