%%%%%%%%
%   P G%
%G%%%%%%
%     X%
%%%%%%%%
