%%%%%%%%%%%%%%%%%%%%
%              %   %
% %% %% %% %% %% % %
%        P       % %
%%%%%%%%%%%%%%%%%% %
%X                 %
%%%%%%%%%%%%%%%%%%%%
